1000111100
1100010110
1111001011
0001000101
0111100101
1101110101
1011110101
1011111001
1111110010
0111101100