0000011110
1010110011
1110101101
1010101101
1001110011
1100011110
0110000100
1011100010
0100111111
1011000000