1111100000
1111000001
1110000011
1100000111
1000001111
0000011111
0000111110
0001111100
0011111000
0111110000